0 0 0 0 0 0 0 0 0 0 0 0 0 0 0 0 0 0 0 0 0 0 0 0 0 0 0 0 0 0 0 0 0 0 0 0 0 0 0 0 0
0 8 9 9 9 9 9 9 9 9 9 9 9 9 9 9 9 9 9 1 9 1 9 9 9 9 9 9 9 9 9 9 9 9 9 9 9 9 9 5 0
0 10 0 0 0 0 0 0 0 0 0 0 0 0 0 0 0 0 0 10 0 10 0 0 0 0 0 0 0 0 0 0 0 0 0 0 0 0 0 10 0
0 10 0 8 9 9 9 9 9 9 9 9 9 9 9 9 9 1 9 2 0 4 9 1 9 9 9 9 9 9 9 9 9 9 9 9 9 5 0 10 0
0 10 0 10 0 0 0 0 0 0 0 0 0 0 0 0 0 10 0 10 0 10 0 10 0 0 0 0 0 0 0 0 0 0 0 0 0 10 0 10 0
0 10 0 10 0 8 9 9 9 9 9 9 9 9 9 5 0 10 0 10 0 10 0 10 0 8 9 9 9 9 9 9 9 9 9 5 0 10 0 10 0
0 10 0 10 0 10 0 0 0 0 0 0 0 0 0 10 0 10 0 10 0 10 0 10 0 10 0 0 0 0 0 0 0 0 0 10 0 10 0 10 0
0 10 0 10 0 10 0 8 9 9 9 9 9 5 0 10 0 10 0 10 0 10 0 10 0 10 0 8 9 9 9 9 9 5 0 10 0 10 0 10 0
0 10 0 10 0 10 0 10 0 0 0 0 0 10 0 10 0 10 0 10 0 10 0 10 0 10 0 10 0 0 0 0 0 10 0 10 0 10 0 10 0
0 10 0 10 0 10 0 10 0 8 9 5 0 10 0 10 0 10 0 10 0 10 0 10 0 10 0 10 0 8 9 5 0 10 0 10 0 10 0 10 0
0 10 0 10 0 10 0 10 0 10 0 10 0 10 0 10 0 10 0 10 0 10 0 10 0 10 0 10 0 10 0 10 0 10 0 10 0 10 0 10 0
0 10 0 10 0 10 0 10 0 10 0 10 0 10 0 10 0 10 0 10 0 10 0 10 0 10 0 10 0 10 0 10 0 10 0 10 0 10 0 10 0
0 10 0 10 0 10 0 10 0 10 0 10 0 10 0 10 0 10 0 10 0 10 0 10 0 10 0 10 0 10 0 10 0 10 0 10 0 10 0 10 0
0 10 0 10 0 10 0 10 0 7 9 3 9 6 0 10 0 10 0 10 0 10 0 10 0 10 0 7 9 3 9 6 0 10 0 10 0 10 0 10 0
0 10 0 10 0 10 0 10 0 0 0 0 0 0 0 10 0 10 0 10 0 10 0 10 0 10 0 0 0 0 0 0 0 10 0 10 0 10 0 10 0
0 10 0 10 0 10 0 7 9 9 9 9 9 9 9 6 0 10 0 10 0 10 0 10 0 7 9 9 9 9 9 9 9 6 0 10 0 10 0 10 0
0 10 0 10 0 10 0 0 0 0 0 0 0 0 0 0 0 10 0 10 0 10 0 10 0 0 0 0 0 0 0 0 0 0 0 10 0 10 0 10 0
0 10 0 10 0 7 9 9 9 9 9 9 9 9 9 9 9 6 0 10 0 10 0 7 9 9 9 9 9 9 9 9 9 9 9 6 0 10 0 10 0
0 10 0 10 0 0 0 0 0 0 0 0 0 0 0 0 0 0 0 10 0 10 0 0 0 0 0 0 0 0 0 0 0 0 0 0 0 10 0 10 0
0 4 9 3 9 9 9 9 9 9 9 9 9 9 9 9 9 9 9 3 9 3 9 9 9 9 9 9 9 9 9 9 9 9 9 9 9 3 9 2 0
0 10 0 0 0 0 0 0 0 0 0 0 0 0 0 0 0 0 0 0 0 0 0 0 0 0 0 0 0 0 0 0 0 0 0 0 0 0 0 10 0
0 4 9 1 9 9 9 9 9 9 9 9 9 9 9 9 9 9 9 1 9 1 9 9 9 9 9 9 9 9 9 9 9 9 9 9 9 1 9 2 0
0 10 0 10 0 0 0 0 0 0 0 0 0 0 0 0 0 0 0 10 0 10 0 0 0 0 0 0 0 0 0 0 0 0 0 0 0 10 0 10 0
0 10 0 10 0 8 9 9 9 9 9 9 9 9 9 9 9 5 0 10 0 10 0 8 9 9 9 9 9 9 9 9 9 9 9 5 0 10 0 10 0
0 10 0 10 0 10 0 0 0 0 0 0 0 0 0 0 0 10 0 10 0 10 0 10 0 0 0 0 0 0 0 0 0 0 0 10 0 10 0 10 0
0 10 0 10 0 10 0 8 9 9 9 9 9 9 9 5 0 10 0 10 0 10 0 10 0 8 9 9 9 9 9 9 9 5 0 10 0 10 0 10 0
0 10 0 10 0 10 0 10 0 0 0 0 0 0 0 10 0 10 0 10 0 10 0 10 0 10 0 0 0 0 0 0 0 10 0 10 0 10 0 10 0
0 10 0 10 0 10 0 10 0 8 9 1 9 5 0 10 0 10 0 10 0 10 0 10 0 10 0 8 9 1 9 5 0 10 0 10 0 10 0 10 0
0 10 0 10 0 10 0 10 0 10 0 10 0 10 0 10 0 10 0 10 0 10 0 10 0 10 0 10 0 10 0 10 0 10 0 10 0 10 0 10 0
0 10 0 10 0 10 0 10 0 10 0 10 0 10 0 10 0 10 0 10 0 10 0 10 0 10 0 10 0 10 0 10 0 10 0 10 0 10 0 10 0
0 10 0 10 0 10 0 10 0 10 0 10 0 10 0 10 0 10 0 10 0 10 0 10 0 10 0 10 0 10 0 10 0 10 0 10 0 10 0 10 0
0 10 0 10 0 10 0 10 0 7 9 6 0 10 0 10 0 10 0 10 0 10 0 10 0 10 0 10 0 7 9 6 0 10 0 10 0 10 0 10 0
0 10 0 10 0 10 0 10 0 0 0 0 0 10 0 10 0 10 0 10 0 10 0 10 0 10 0 10 0 0 0 0 0 10 0 10 0 10 0 10 0
0 10 0 10 0 10 0 7 9 9 9 9 9 6 0 10 0 10 0 10 0 10 0 10 0 10 0 7 9 9 9 9 9 6 0 10 0 10 0 10 0
0 10 0 10 0 10 0 0 0 0 0 0 0 0 0 10 0 10 0 10 0 10 0 10 0 10 0 0 0 0 0 0 0 0 0 10 0 10 0 10 0
0 10 0 10 0 7 9 9 9 9 9 9 9 9 9 6 0 10 0 10 0 10 0 10 0 7 9 9 9 9 9 9 9 9 9 6 0 10 0 10 0
0 10 0 10 0 0 0 0 0 0 0 0 0 0 0 0 0 10 0 10 0 10 0 10 0 0 0 0 0 0 0 0 0 0 0 0 0 10 0 10 0
0 10 0 7 9 9 9 9 9 9 9 9 9 9 9 9 9 3 9 2 0 4 9 3 9 9 9 9 9 9 9 9 9 9 9 9 9 6 0 10 0
0 10 0 0 0 0 0 0 0 0 0 0 0 0 0 0 0 0 0 10 0 10 0 0 0 0 0 0 0 0 0 0 0 0 0 0 0 0 0 10 0
0 7 9 9 9 9 9 9 9 9 9 9 9 9 9 9 9 9 9 3 9 3 9 9 9 9 9 9 9 9 9 9 9 9 9 9 9 9 9 6 0
0 0 0 0 0 0 0 0 0 0 0 0 0 0 0 0 0 0 0 0 0 0 0 0 0 0 0 0 0 0 0 0 0 0 0 0 0 0 0 0 0